R 1600 900


NO ./texture/north.xpm
SO ./texture/south.xpm
WE ./texture/west.xpm
EA ./texture/east.xpm

S ./texture/pillar.xpm
F 220,100,0
C 225,30,0


111111111111
10000000001111
11000000000001111111
 1111111111000001111111111111
 1110000000001000000001100001 1111
1111110020000100000000110000111001111111
    11110000000110000110000000000001111
     10000000010000000100000000011111
    1111111100000000222200000000011
     111100000000000000000000000001
 11111100000100000000N0000000001111111
 100000000001000200000000000000000011
 100001111001110000000000000000000001
 111001  1001 10001000000011111111111
   1111  1111 1011111111111111
    1         111           11
